

Irritable|Irritably
Lively|Livelyly
Brave|Bravely
Soaring|Soaringly
Omnipotent|Omnipotently
Succulent|Succulently
Devious|Deviously
Bright|Brightly
Vivacious|Vivaciously
Tender|Tenderly
Voguish|Voguishly
Vapid|Vapidly
Sleek|Sleekly
Plucky|Pluckily
Cynical|Cynically
Oreintal|Oreintally
Shrewd|Shrewdly
Snazzy|Snazzily
Perfect|Perfectly
Amiable|Amiably
Mammoth|Mammothly
Infamous|Infamously
Nomadic|Nomadically
Ritzy|Ritzily
Apt|Aptly
Sultry|Sultrily
Frivolous|Frivolously
Granulated|Granulatedly
Fleeting|Fleetingly
Credible|Credibly
Grisly|Grislyly
Lofty|Loftily
Grand|Grandly
Cozy|Cozily
Expectant|Expectantly
Forsaken|Forsakenly
Leggy|Leggily
Eminent|Eminently

Fuzzy|fuzzily
Pretty|prettyly
Tidy|tidily
Sloppy|sloppily
Courageous|courageously
Innocent|innocently
Amused|amusedly
Repulsive|repulsively
Fragrant|fragrantly
Furious|furiously
Delightful|delightfully
Brave|bravely
Stupid|stupidly
Patient|patiently
Astonishing|astonishingly
Grimy|grimily
Harsh|harshly
Painful|painfully
Elegant|elegantly
Nervous|nervously
Obedient|obediently
Moral|morally
Cruel|cruelty
Lively|livelyly
Moody|moodily
Ugly|uglily
Rich|richly
Strong|strongly
Careless|carelessly
Jealous|jealously
Sorrowful|sorrowfully
Tall|tallly
Keen|keenly
Brave|bravely
Thin|thinly
Humorous|humorously
Mysterious|mysteriously
Brave|bravely
Lazy|lazily
Warm|warmly
Mature|maturely
Agile|agilely
Gorgeous|gorgeously
Pretty|prettyly
Funny|funnily
Brave|bravely
Cheerful|cheerfully
Humble|humbly
Confused|confusedly
Brave|bravely
Lonely|lonlely
Miserable|miserably
Original|originally
Agitated|agitatedly
Eager|eagerly
Faded|fadedly
Sneaky|sneakily
Calm|calmly
Shy|shyly
Flashy|flashily
Grumpy|grumpily
Terrific|terrifically
Trustworthy|trustworthily
Worthless|worthlessly
Brave|bravely
Gentle|gently
Foolish|foolishly
Generous|generously
Luxurious|luxuriosly
Dynamic|dynamically
Grieving|grievingly
Zealous|zealously
Scared|scaredly
Bashful|bashfully
Lively|livelyly
Brave|bravely
Fierce|fiercely
Fancy|fancyly
Creative|creatively
Loud|loudly
Brave|bravely
Insulting|insultingly
Romantic|romantically
Tough|toughly
Quick|quickly